# Syntax Coloring Map For ModbusRTUMaster

# Classes and Objects (KEYWORD1)
ModbusRTUMaster	KEYWORD1
ModbusRequest	KEYWORD1
ModbusCallback	KEYWORD1
ModbusRTUMaster_RS485	KEYWORD1

# Methods and Functions (KEYWORD2)
begin	KEYWORD2
setTimeout	KEYWORD2
manage	KEYWORD2
pushRequest	KEYWORD2
getQueueCount	KEYWORD2
clearQueue	KEYWORD2
readCoils	KEYWORD2
readDiscreteInputs	KEYWORD2
readHoldingRegisters	KEYWORD2
readInputRegisters	KEYWORD2
writeSingleCoil	KEYWORD2
writeSingleRegister	KEYWORD2
writeMultipleCoils	KEYWORD2
writeMultipleRegisters	KEYWORD2
setTransmissionCallbacks	KEYWORD2

# Constants (LITERAL1)
MODBUS_FC_READ_COILS	LITERAL1
MODBUS_FC_READ_DISCRETE_INPUTS	LITERAL1
MODBUS_FC_READ_HOLDING_REGISTERS	LITERAL1
MODBUS_FC_READ_INPUT_REGISTERS	LITERAL1
MODBUS_FC_WRITE_SINGLE_COIL	LITERAL1
MODBUS_FC_WRITE_SINGLE_REGISTER	LITERAL1
MODBUS_FC_WRITE_MULTIPLE_COILS	LITERAL1
MODBUS_FC_WRITE_MULTIPLE_REGISTERS	LITERAL1
MODBUS_QUEUE_SIZE	LITERAL1
MODBUS_MAX_BUFFER	LITERAL1
MODBUS_DEFAULT_TIMEOUT	LITERAL1
MODBUS_DEFAULT_INTERFRAME_DELAY	LITERAL1
MODBUS_EXCEPTION_ILLEGAL_FUNCTION	LITERAL1
MODBUS_EXCEPTION_ILLEGAL_DATA_ADDRESS	LITERAL1
MODBUS_EXCEPTION_ILLEGAL_DATA_VALUE	LITERAL1
MODBUS_EXCEPTION_SLAVE_DEVICE_FAILURE	LITERAL1
